TTTTTTTT.TTTTTTTTTTTTTTT
T          TTXTTTT     T
T R  T TTRT  TRRRTTTT  T
T  TTTTTTTT  TTTTTTTT  T
T            TTT    X  T
T X  TTT TTTTT       TTT
T    T    X     TTRRTTTT
T    TT TTTT  TTTTTT X T
TTTTTTR TTTTXXX      T T
TRTTTTR TTTTTTTTTTTTTT T
TTTTTT                 T
TTTRTTTT  TTTTTTTTTTTTRR
TTTTTTRTTTTTTTTTTTTTTRTT