TTTTTTTTTTTTTTTTTTTTTTTT
T    T       X TTT     T
T R  T TTRT  T     TT  T
T    TTTTTT  TTTTTTTT  T
T            TTTTTTTX  T
T X  TTTTTTTTT       TTT
T    T    X     TTRRTTTT
T    TTTXTTT  TTTTTT X T
TTTTTTRRXTTT         T T
TRTTTTRTXTTTTTTTTTTTTT T
TTTRTTTR               T
TTTRTTTT  TTTTTTTTTTTTRR
TTTTTTRT.TTTTTTTTTTTTRTT